a customer base: Nguồn khách hàng
a question regarding something: Một câu hỏi liên quan đến một vấn đề nào đó
a tough decision: Quyến định khó khăn
a wealth of experience: Nhiều kinh nghiệm
acquire knowledge: Tiếp thu kiến thức
budget constraints: Ràng buộc về ngân sách
budget cuts: Sự cắt giảm ngân sách
comprehensive experience: Kinh nghiệm toàn diện
display a parking permit: Xuất trình vé gửi xe
reach a conclusion: Đi đến kết luận
make a decision: Đưa ra quyết định
to address concerns: Giải quyết mối bận tâm
assist a customer: Hỗ trợ khách hàng
broaden knowledge: Mở rộng kiến thức
conduct a survey: Tiến hành một cuộc khảo sát
cut costs: Cắt giảm chi phí
deliver a presentation: Thuyết trình
exorbitant price: Giá cắt cổ
gain experience: Đạt được kinh nghiệm
hands-on experience: Kinh nghiệm thực tế
operate a machine: Vận hành máy móc
patronize a restaurant: Trở thành khách hàng quen thuộc của một nhà hàng
prospective employees: Những nhân viên tiềm năng
reject a proposal: Bác bỏ một đề nghị
relocate a manufacturer: Di chuyển nhà máy
rough estimate: Bản báo cáo sơ bộ
shoestring budget: Ngân sách eo hẹp
take employees' suggestions into account: Xét xét các đề nghị của nhân viên
utilize a new method: Sử dụng phương pháp mới
violate health regulations: vi phạm những quy định về sức khỏe
