receive a bulk discount on items: nhận chiết khấu số lượng lớn cho các mặt hàng 
receive a partial refund: nhận một phần hoàn lại
be misinformed about a store policy: thông tin sai về chính sách cửa hàng 
a sports tournament: một giải đấu thể thao 
be postponed due to severe weather: bị hoãn lại do thời tiết khắc nghiệt 
energy-efficient household appliances: thiết bị gia dụng tiết kiệm năng lượng 
accompany a co-worker to a workshop: đi cùng đồng nghiệp hội thảo
the service is impeccable: dịch vụ hoàn hảo 
reach an impression milestone: đạt được một cột mốc ấn tượng 
the economy remains extremely fragile: nền kinh tế còn nhiều yếu kém
all information will be treated as strictly confidential: mọi thông tin sẽ được bảo mật nghiêm ngặt 
with the generosity of sponsors: với lòng hảo tâm của các mạnh thường quân 
protect old and fragile documents: bảo vệ tài liệu cũ và dễ hỏng
apply for some government grants: xin một số khoản trợ cấp của chính phủ
have a shortfall: số lượng thiếu hụt
the exterior of the building: ngoại thất/vẻ bề ngoài của toà nhà
undergo a spectacular transformation: trải qua một cuộc chuyển đổi ngoạn mục
due to a downturn in the local economy: do nền kinh tế địa phương đang suy thoái
something will be revamped: cái gì đó sẽ được sửa sang, tân trang lại
have a wealth of experience: có nhiều kinh nghiệm
reduce overhead expenses: giảm chi phí chung
be available exclusively at (place): chỉ có sẵn tại (địa điểm)
enjoy complimentary refreshments: thưởng thức đồ uống giải khát miễn phí
soon-to-be-released products: sản phẩm sắp phát hành
raise company morale: nâng cao tinh thần công ty
enjoy the marine leisure activities with nominal fees: tận hưởng các hoạt động giải trí trên biển với mức chi phí rất thấp
fill out the attached consent from: điền vào mẫu đồng ý đính kèm
detail any costs incurred by you in going on a business trip: liệt kê chi tiết bất kì chi tiêu nào bạn đã chi trong công việc
the building project is proceeding smoothly: dự án toà nhà đang tiến hành suôn sẻ
adhere to the terms of the agreement: tuân thủ các điều khoản của thoả thuận/hiệp ước