prices range from...to...: giá từ...đến...
a corrected minutes: một biên bản đã được chỉnh sửa
senior citizen discounts: giảm giá cho người già
top-notch technical skills: kỹ năng về kỹ thuật hàng đầu
cost-effective and environmentally-friendly alternatives: Giải pháp thay thế có thể sinh lời và thân thiện với môi trường
an in-depth study: một nghiên cứu chuyên sâu
be delighted to announce that: vui mừng thông báo rằng
lean towards multi-national companies: hướng về các công ty đa quốc gia
dissatisfy previous customers: không hài lòng khách hàng cũ
violate an agreement: vi phạm hợp đồng
take over director's role: đảm nhận vai trò của giám đốc
provide quality garments at affordable prices: cung cấp hàng may mặc chất lượng với giá tốt
place an order: đặt hàng
hazardous chemicals: những hoá chất nguy hiểm
explore new and untapped markets: tiếp cận những thị trường mới và chưa được khai thác
compete with rival sporting attire manufacturer: cạnh tranh với nhà sản xuất trang phục thể thao đối thủ
sustainable energy technology: công nghệ năng lượng bền vững
cutting-edged facilities: cơ sở vật chất tối tân
mutually beneficial business agreement: thoả thuận kinh doanh các bên cùng có lợi
an unsatisfactory product: một sản phẩm không đem lại sự hài lòng
be responsible for liaising with clients: có trách nhiệm liên lạc với khách hàng
be subject to change depending on the construction's progress: có thể thay đổi tuỳ thuộc vào tiến độ xây dựng
the work will mainly entail: công việc chủ yếu sẽ bao gồm
be a great summer hotspot: là một điểm thu hút tuyệt vời cho mùa hèd
casual meals on a budget: bữa ăn bình dân
have a wide selection of appetizers and entrees: có nhiều lựa chọn về món khai vị và món chính
exotic dishes: món ăn độc lạ
specialize in Italian cuisine: chuyên về ẩm thực Ý
have large portions for a low price: những phần ăn lớn với giá thấp
be reserved in advance to avoid disappointment: đặt chỗ trước để tránh thất vọng
cause a temporary road closure: khiến con đường tạm thời bị đóng
