proofread  a manual: Đọc lại sách hướng dẫn (để tìm lỗi)
the outcome of a vote: Kết quả của một cuộc bỏ phiếu
offer financial incentives to staff: Đưa ra các ưu đãi/khích lệ tài chính cho nhân viên
unveil a new line of haircare products: Ra mắt dòng sản phẩm chăm sóc tóc mới
an amended financial plan: Kế hoạch tài chính được sửa đổi
talk directly to representatives from: Trao đổi trực tiếp với đại diện từ
the highest-grossing movie: Phim có doanh thu cao nhất
earn accolades and awards: Đạt được các danh hiệu và giải thưởng
recommend a good solicitor for drawing up a will: Đề nghị một luật sư giỏi để lập di chúc
sufficient parking for patrons: Có đủ chỗ đậu xe cho khách quen
institute a new parking policy: Thiết lập một chính sách đậu xe mới
enforce a policy: Thực thi chính sách
replace out-of-date software: Thay thế phần mềm lỗi thời
make an ultimate decision about: Đưa ra quyết định cuối cùng về
foster social relationships: Thúc đẩy các mối quan hệ xã hội
to be the region’s most trusted retailer: Trở thành nhà bán lẻ đáng tin cậy nhất trong khu vực
give more details upon request: Cung cấp thêm chi tiết theo yêu cầu
a reputation for high standards of discipline: Danh tiếng về tiêu chuẩn cao về kỷ luật
read customer testimonials: Đọc lời chứng thực của khách hàng
be made of water-proof fabric: Được làm bằng vải chống nước
join a brainstorming meeting: Tham gia một cuộc họp cần phải động não
draft marketing report: Dự thảo báo cáo tiếp thị
something is affixed to something: Một cái gì đó được gắn với một cái gì đó
an expiration date: Ngày hết hạn
in research laboratories: Trong các phòng thí nghiệm nghiên cứu
a corporate attorney: Một luật sư của công ty
white-collar jobs: Công việc văn phòng
a bustling area: Một khu vực nhộn nhịp
newspaper’s circulation has dropped every year: Số lượng phát hành của báo đã giảm hàng năm
skyrocketing rents: Giá thuê tăng vọt