Notwithstanding the aforementioned drawbacks: Mặc cho những nhược điểm đã nói ở trên
Potential vendors: Các nhà cung cấp tiềm năng
A vibrant start-up culture: Một nền văn hóa khởi nghiệp sôi động
Make lucrative deals: Thực hiện các giao dịch sinh nhiều lãi/ lợi nhuận
Develop innovative products: Phát triển các sản phẩm sáng tạo
Contact a business attorney: Liên hệ với luật sư lĩnh vực kinh doanh
Provide made-to-order apparel: Cung cấp quần áo may theo đơn hàng
A fund-raising event: Một sự kiện gây quỹ
Expedite a delivery: Xúc tiến việc giao hàng
Accommodate one's request: Đáp ứng yêu cầu của một người
Be affiliated with a company: Liên kết với một công ty
Large-size beverages: Đồ uống cỡ lớn
Attend an art gallery: Tham dự một phòng trưng bày nghệ thuật
Improve kitchen sanitation: Cải thiện vệ sinh nhà bếp
Keep track of time: Theo dõi thời gian
Endure intense heat: Chịu đựng cái nắng gay gắt
The latest gadgets: Các thiết bị mới nhất
Express gratitude towards: Bày tỏ lòng biết ơn
Purchase real estate for a new retail location: Mua bất động sản để làm địa điểm bán lẻ mới
Donate to a charity event: Quyên góp cho một sự kiện từ thiện
Give out vouchers as thank-you gifts: Tặng/Phát phiếu mua hàng làm quà cảm ơn
Make an impression on something: Tạo ấn tượng về điều gì đó
Be responsive to your requests: Đáp ứng/Trả lời những yêu cầu của bạn
Reserve a spot prior to the start of a tour: Đặt chỗ trước khi bắt đầu chuyến tham quan
Thoroughly enjoy a tour: Tận hưởng triệt để một chuyến tham quan
Single-use plastic items: Các mặt hàng nhựa dùng một lần
A new city ordinance: Một sắc lệnh mới của thành phố
Postpone interviews: Hoãn phỏng vấn
Business strategies about regional expansions: Chiến lược kinh doanh để mở rộng khu vực
cordially invite you to: Trân trọng kính mời các bạn
