policies to attract commercial enterprises: Chính sách thu hút doanh nghiệp thương mại
prime-time television: truyền hình thời gian chính thức/khung giờ vàng
collect your bags from the baggage claim: lấy hành lý của bạn từ khu hành lý
go to the domestic terminal: đi đến nhà ga quốc nội
have a two-day stopover: quá cảnh hai ngày
a cargo ship: một con tàu chở hàng
comprehensive car insurance covers damage from: bảo hiểm xe ô tô toàn diện bao gồm các thiệt hại do
produce accessories: sản xuất các phụ kiện
hold a ballot on something: bỏ một lá phiếu về một cái gì đó
a growing consensus among shareholders: sự đồng thuận ngày càng tăng giữa các cổ đông
read the minutes of last month's meeting: đọc biên bản cuộc họp tháng trước
unanimously agree that: nhất trí đồng ý rằng
register copyright to prevent unauthorized publication: đăng ký bản quyền để ngăn chặn việc xuất bản trái phép
something is conundrum: vấn đề gì đó hóc búa
crops sprayed with insecticides: cây trồng bị phun thuốc trừ sâu
a reduction in milk yield: sản lượng sữa giảm
the cultivation of a good relationship with local firms: nuôi dưỡng mối quan hệ tốt với doanh nghiệp địa phương
a government commitment to reduce greenhouse gas emissions: cam kết của chính phủ nhằm giảm khí thải nhà trắng
spring is just around the corner: mùa xuân sắp đến
the product will be dispatched today: sản phẩm sẽ được gửi hôm nay
thank you for your patronage: cảm ơn bạn vì tới lui thường xuyên để mua hàng
non-toxic ingredients: thành phần không độc hại
follow eco-friendly practices and use sustainable building materials: tuân theo các cách thân thiện với môi trường và sử dụng vật liệu xây dựng bền vững
reduce energy consumption: giảm tiêu thụ năng lượng
meet criteria: đáp ứng tiêu chí
nominate a company for prestigious awards: đề cử một công ty cho các giải thưởng danh giá
boost sales in a shop: tăng doanh số bán hàng tại một nhà hàng
register for a trade expo: đăng ký triển lãm thương mại
be required to complete mandatory software training sessions: được yêu cầu hoàn thành các buổi đào tạo phần mềm bắt buộc
have some scheduling conflicts: trùng lịch
